*abbreviation = Kısaltma.
*adverb = zarf
*adjective = sıfat
*advisor = danışman
*annual = yıllık, senelik
*authentication = Doğrulama.
*badge = Rozet, nişan.
*benchmark = kalite testi
*benefit = fayda, yarar
*brand = Marka.
*carousel = Atlı karınca, slider menü.
*clarify = açıklamak
*cluster = küme
*collapse = Daraltmak.
*conjuction = bağlaç
*district = İlçe, semt.
*disburse = ödeme, harcama yapmak
*dismiss = Sonlandırmak, kovmak.
*ensure = Emin olmak.
*environment = ortam
*examine = kontrol etmek
*fewer = daha az
*figure = şekil, rakam
*firm = firma
*gutter = Kolonların arasındaki pay veya alan.
*indicate = Belirtmek, göstermek, bildirmek.
*latency = gecikme
*lottery = piyango
*luxury = lüks
*miscellaneous = Çeşitler
*neutral = Tarafsız, bağımsız.
*noun = isim
*plain = sade, yalın
*pop over = üzerine gelmek
*pop up = çıkagelmek, belirmek
*prepend = Başa eklemek.
*preposition = edat
*procedure = prosedür
*pronoun = zamir
*recipe = tarif
*review = gözden geçirmek
*sack = çuval, kovulmak
*save = kaydetmek, tasarruf etmek
*shrink = Küçültmek, sığdırmak için küçültmek.
*signature = imza
*specialist = uzman
*split = Bölmek, ayırmak.
*separate = Ayırmak.
*temporary = geçici
*till = kasa
*toggle = Geçiş
*trace = iz
*treat = Davranmak
*whose = kimin
*wrapper = Örtü, saran şey
*whom = kimi, kime
*verb = fiil
