--------------------------------------------------------------------------------------------------------------------------
*****BASİC HTML*****
*!DOCTYPE : HTML dökümanları bu bildiriyle başlamak zorundadır.Belgenin türünü bildirir.
*head : HTML dökümanının başlığını tanımlar.Meta datalardır.
*title : HTML belgesinin başlığıdır.Salt texttir.
*body : HTML belgesinin gövdesidir.Tüm içerik buradadır.
*h1 : Sayfa başlığıdır.En önemlisidir.
*h2 : Sayfa başlığıdır.En önemlisidir. 
*h3 : Sayfa başlığıdır.En önemlisidir.
*h4 : Sayfa başlığıdır.En önemlisidir.
*h5 : Sayfa başlığıdır.En önemlisidir.
*h6 : Sayfa başlığıdır.En önemsizidir.
*p : Paragraf oluşturur. 
*br : İçeriğe bulunduğu satırda satır sonu uygular.
*hr : Yatay rule(çizgi) oluşturur.
********************
*****FORMATTİNG HTML TAGS*****
*abbr : İfadeyi sayfada belirgin şekle sokar.
*adress : Bir belgenin veya makalenin iletişim bilgilerini saklar.
*b : Texti kalınlaştırır fakat bunun yerine <strong> kullanın.
*bdi : Ters yönlü biçimlendirilecek textlere(Mesela Arapça) izolasyon sağlar.
*bdo : Textlerin biçimlendirme yönlerini(sağ-sol) belirtir.
*blockquoute : Başka bir kaynaktan alıntı yapılan bir bölümü belirtir.
*cite : Bir eserin, çalışmanın veya yapıtın başlığını belirtir.Genellikle italic yapar.
*code : Bilgisayar kodunu tanımlar ve texti monoscape fontunda görüntüler.
*del : HTML belgesinden silinmiş texti belirtir.Üzeri çizgili şekilde görüntüler.
*dfn : Tanımlanacak olan elementi belirtir.Genellikle italic yapar.
*em : Texti vurgulamak için kullanılır.Genellikle italic yapar.
*i : Texti farklı moodda tanımlar.Genellikle italic yapar fakat buunun yerine <em> kullanın.
*ins : Belgeye eklenmiş texti tanımlar.Altı çizgili olarak görüntüler.
*kbd : Klavye inputunu tanımlar ve texti monoscape fontunda görüntüler.
*mark : Vurgulanacak veya işaretlenmiş olan texti belirtir.Backgroundı sarı yapar.
*meter : Skaler bir ölçümü veya kesirli bir değeri tanımlar.
*pre : İçeriği, HTML kaynak kodunda olduğu gibi hiç formatlamadan görüntüler.
*progress : Bir taskın, tamamlanma sürecindeki ilerlemesini belirtir.
*q : Kısa bir alıntıyı belirtir.Etrafına tırnak işaretleri ekler.
*s : Textin artık doğru veya alakalı olmadığını belirtir.Üzerini çizer.
*samp : Bilgisayar programından örnek outputu tanımlar ve monoscape fontunda tanımlar.
*small : Texti daha küçük halde görüntüler.
*strong : Texti kalın yapar.
*sub : Alt simgeli texti tanımlar.
*sup : Üst simgeli texti tanımlar.
*template: JS için templateler oluşturur.Genelde gizli tutulan içeriklerdir; JS ile gösterilir.
*time : Datetime ayarları yapılarak belirli tarih tanımlamaları yapar(sevgililer günü,işçi bayramı,vs..).
*u : Genellikle yanlış yazılmış sözcükler veya özel adları belirtir.Texti altı çizgili görüntüler.
*var : Programlamada veya matematiksel ifadedeki değişkenleri belirtir.İçeriği italic gösterir.
*wbr : Satır sonu uygular fakat sadece zorunlu durumlarda devreye girer.
*************************
*****FORMS AND INPUT*****
*form : Kullanıcı için bir HTML formu oluşturur.
*input : Kullanıcının veri girebileceği bir input alanı belirtir.
*textarea : Kullanıcının veri girebileceği çok satırlı bir input alanı belirtir.
*button : Tıklanabilir bir button oluşturur.
*select : Drop-down listesi oluşturur.
*optgroup : Gruplandırılmış halde olan bir drop-down listesi oluşturur.
*label : Elementler için levha görevi görür ve üzerine tıklanıldığında ilgili input alanına yönlendirir.
*fieldset : Bir formdaki elementleri gruplandırır ve çevresini container olarak sarar.
*legend : <fieldset> tagı içerisinde kullanılır ve başlıkları belirtir.
*datalist : Bir input alanı için önceden tanımlanmış optionların bir listesini belirtir.
*output : İnputlar arasında bir matematiksel hesaplamanın sonucunu ifade eder.
*************************
*****FRAMES*****
*iframe : Mevcut HTML belgesine ekleme yapabilmek için inline bir çerçeve belirtir.
****************
*****İMAGES*****
*img : HTML sayfasına bir resim eklemek için kullanılır.
*map : <img> tagında tanımlanan görselin image haritasını tanımlar.
*area : <map> içerisinde kullanılır ve görüntü haritasının her tıklanabilir alanını tanımlar.
*canvas : JS ile grafik çizimleri için kullanılır; grafikler için bir transparent containerdır.
*figcaption : <figure> tagı için bir başlık sağlar.
*figure : İlüstrasyonlar, diyagramlar, resimler gibi bağımsız içerikleri belirtir.
*picture : Responsive tasarımlar için, bir görüntüye birden fazla source sağlar.
*svg : Grafik görselleri çizmek için kullanılır; SVG grafikleri için bir containerdır.
****************
*****AUDİO/VİDEO*****
*audio : HTML belgesine bir ses içeriği eklememizi sağlar.
*source : <video>, <audio>, <picture> tagları için birden fazla medya sourceu sağlar.
*track : <audio> ve <video> tagları için text parçaları(altyazı vs) belirtir. 
*video : HTML belgesine video içerikleri ekler.
*********************
*****LİNKS*****
*a : Bir sayfadan diğerine bağlantı vermek için kullanılan hyperlinktir.
*link : Mevcut belge ile external belge arasındaki ilişkiyi tanımlar.
*nav : Navigasyon linklerinden oluşan temel gezinme bloğudur.
***************
*****LİSTS*****
*ul : Sırasız liste tanımlar.
*ol : Sıralı liste tanımlar.Sıralama alfabetik veya numerik de olabilir.
*li : Listedeki elementleri tanımlar.
*dl : Bir açıklama listesi tanımlar.
*dt : Açıklama listesindeki terimleri tanımlar.
*dd : Açıklama listesindeki her terimi tanımlar(alt başlık gibi).
***************
*****TABLES*****
*table : Bir HTML tablosu tanımlar.
*caption : Tablo başlığını tanımlar; first-chıld olarak kullanırız.
*th : HTML tablosu içerisinde bir başlık hücresini tanımlar.
*tr : HTML tablosundaki satır hücresini tanımlar.
*td : HTML tablosun içerisinde standart bir veri hücresi tanımlar.
*thead : HTML tablosunun header içeriğini gruplandırır ve temsil eder.
*tbody : HTML tablosunun body içeriğini gruplandırır ve temsil eder.
*tfooter : HTML tablosunun footer içeriğini gruplandırır ve temsil eder.
*col : <colgroup> tagı içerisindeki sütunları spesifik olarak biçimlendirebilir.
*colgroup : Tablodaki bir veya daha fazla column grubunu belirtir; biçimlendirmek içindir. 
****************
*****STYLE AND SEMANTİCS*****
*style : Bir döküman için CSS tanımlamak için kullanılır.
*div : HTML içerisinde bir parçayı veya sectionı tanımlayan bir containerdır.
*span : Bir textin bölümünü veya bir belgenin bölümünü işaretlemek için kullanılan bir inline containerdır.
*header : Kullanıcıya tanıtım içeriği için bir container veya navigasyon linkini temsil eder.
*main : Bir belgenin ana gövdesini yani temel içeriğini belirtir.
*section : Bir belgedeki sectionları(bölümleri) tanımlar.
*article : Belgeden bağımsız kalabilen ve kendi başına yeten içerikleri tanımlar(makale,haber postu,vs).
*aside : Yerleştirildiği containerın dışında bazı içerikleri tanımlar(sidebar,vs).
*details : Kullanıcın istek üzerine açıp kapatabileceği ve içerisinde ek ayrıntılar içeren bir pencere tanımlar.
*dialog : Bir dialog boxı veya subwindow tanımlar.
*summary : <details> tagı için bir başlık tanımlar.Tıklanarak açılıp kapanabilir.
*data- : Belge içerisindeki belirli bir içeriğin makine tarafında okunabilir bir translateini eklemek için kullanılır.
*****************************
*****META INFO*****
*head : Metadatalar için bir containerdır.
*meta : HTML hakkındaki metadataları tanımlar.
*base : Bir belgedeki tüm relative URLler için temel "URl"yi veya "target"ı belirtir. 
*******************
*****PROGRAMMİNG*****
*script : Client-side(istemci taraflı) script eklemek için kullanılır.
*noscript : Scriptleri devre dışı bırakılmış veya desteklenmeyen browserlarda görüntülenecek alternatif içerikler tanımlar. 
*embed : Web sayfası, resim, medya oynatıcı veya plug-in uygulaması gibi external kaynaklar için bir containerdır. 
*object : Web sayfası, resim, medya oynatıcı veya plug-in uygulaması gibi external kaynaklar için bir containerdır. 
*param : Bu etiket, bir <object> tagı için parametreleri tanımlamak için kullanılır.
*********************
*****GLOBAL ATTRİBUTES*****
*accesskey : Bir elementi focuslamak/aktif etmek için bir shortkeydir.
*class : Bir element için bir veya birden fazla class adını belirtir.
*contenteditable : Elementin içeriğinin editlenebilir olup olmadığını belirtir.
*data-* : Sayfaya veya uygulamaya custom private dataları depolamak için kullanılır.
*dir : Elementin içeriğinin text yönünü belirtir.
*draggable : Bir elementin sürüklenebilir olup olmadığını belirtir.
*hidden : Elementin görüntülenmemesi gerektiğini belirtir. 
*id : Element için unique bir kimlik belirtir.
*lang : Elementin içeriğinin dilini belirtir.
*spellcheck : Elementin yazım ve grammerinin denetlenip denetlenmeyeceğini belirtir.
*style : Bir inline CSS belirtir.
*tabindex : Elementlerin tab sırasını belirtir.
*title : Element hakkında ek bilgiler içerir.Tooltip textler halinde gösterilir.
*translate : Elementin translate edilip edilmeyeceğini belirtir.
***************************
*****WİNDOW EVENT ATTRİBUTES*****
*onafterprint : Bir sayfa print edilmeye başladığında veya print dialog boxı kapatıldığında etkinleşir.
*onbeforeprint : Bir sayfa print edilmek üzereyken(print dialog boxı henüz görünmeden önce) etkinleşir.
*onbeforeunload : Belgeden çıkılmak veya refreshlenmek üzereyken confirm box etkinleştirir. 
*onerror : External bir dosya(belge,resim,vs..) yüklenirken hata oluştuğunda etkinleşir.
*onhashchange : Geçerli URL'nin bağlantı parçasında(# ile başlayan) değişiklikler olduğunda etkinleşir.
*onload : Web sayfasındaki tüm içerik yüklendikten sonra etkinleşir.
*onoffline : Browser, offline çalışmaya başladığında etkinleşir.
*ononline : Browser, online çalışmaya başladığında etkinleşir.
*onpagehide : Kullanıcı, bir sayfadan ayrıldığında etkinleşir.
*onpageshow : Kulanıcı, bir web sayfasına gittiğinde etkinleşir(her defasında).
*onpopstate : Window'un geçmişi değiştirdiğinde(temizlediğinde) etkinleşir. 
*onresize : Window'un penceresi yeniden boyutlandırıldığında etkinleşir.
*onstorage : Web depolama(storage) alanı güncellendiğinde etkinleşir
*onunload : Bir sayfadan çıkıldığında veya browser penceresi kapatıldığında etkinleşir. 
*********************************
*****FORM EVENT ATTRİBUTES*****
*onblur : Elementin focusunu kaybettiği an etkinleşir.
*onchange : Elementin valuesini değiştirdiği an etkinleşir.
*oncontextmenu : Kullanıcının context menu açmak için elemente sağ tıkladığında etkinleşir.
*onfocus : Elementin focuslandığı an etkinleşir.
*oninput : Elementin, kullanıcı inputu alıp valuesi değiştiğinde etkinleşir.
*oninvalid : Submit edilebilir bir <input> elementi, invalid döndüğü anda etkinleşir.
*onreset : Formun resetlendiği anda etkinleşir.
*onsearch : Kullanınıcının <input type="search"> elementinde "ENTER" tuşuna bastığında etkinleşir.
*onselect : Elementin içerisinde bazı textler seçildikten sonra etkinleşir.
*onsubmit : Form submit edildikten sonra etkinleşir.
*********************
*****KEYBOARD EVENT ATTRİBUTES*****
*onkeydown : Kullanıcı, keyboarddan bir tuşa bastığında etkinleşir.
*onkeypress : Kullanıcı, keyboarddan bir tuşa basıyorken etkinleşir.
*onkeyup : Kullanıcı, keyboarddan bir tuşa basmayı bırakınca etkinleşir.
***********************************
*****MOUSE EVENT ATTRİBUTES*****
*onclick : Mouse ile tıklanıldığında etkinleşir.
*ondbclick : Mouse ile çift tıklanıldığında etkinleşir.
*onmousedown : Mouse ile elementin üzerindeyken tıklanıldığında etkinleşir.
*onmousemove : Mouse ile ekrandaki pointerı elementin üzerindeyken hareket ettirmesiyle etkinleşir.
*onmouseout : Mouse ile ekrandaki pointerı elementin dışına çıkardığında etkinleşir.
*onmouseover : Mouse ile ekrandaki pointerı elementin üzerine getirdiğinde etkinleşir.
*onmouseup : ELementin üzerindeyken mouse ile basmayı bıraktığında etkinleşir.
*onwheel : Elementin üzerindeyken tekerleğin aşağı veya yukarı yuvarlanmasıyla etkinleşir.
********************************
*****DRAG EVENT ATTRİBUTES*****
*ondrag : Seçilen bir elementi veya texti sürüklerken etkinleşir. 
*ondragend : Seçilen bir elementi veya texti sürüklemeyi bıraktığında etkinleşir.
*ondragenter : Seçilen bir elementin veya textin geçerli bir drop areaya girmesiyle etkinleşir.
*ondragleave : Seçilen bir elementin veya textin geçerli bir drop areadan çıkmasıyla etkinleşir.
*ondragover : Seçilen bir elementin veya texin geçerli bir drop area üzerinde sürüklenmesiyle etkinleşir.
*ondragstart : Seçilen bir element veya text, sürüklenmeye başladığında etkinleşir.
*onscroll : Elementin scroll barını aşağı veya yukarı kaydırırken etkinleşir.
*******************************
*****CLİPBOARD EVENT ATTRİBUTES*****
*oncopy : Bir elementin içeriğini(görsel,text,vs..) kopyaladığında etkinleşir
*oncut : Bir elementin içeriğini(görsel,text,vs..) kestiğinde etkinleşir
*onpaste : Bir elementin içeriğini(görsel,text,vs..) yapıştırdığında etkinleşir
************************************
*****MISC EVENT ATTRİBUTES*****
*toggle : Kullanıcının <details> tagını açmasıyla etkinleşir.
*******************************
