*****SELECTORS*****
*active : Aktif haldeki(tıklanılmakta olan) linkleri seçer.
*after : Seçilen her elementin içeriğinden sonra birşey ekler.
*before : Seçilen her elementin içeriğinden önce birşey ekler.
*checked : "checked" attributeune sahip olan elementlerle eşleşir.
*default : İlgili elementler grubundaki "default" olarak atanmış form elementini seçer.
*disabled : "disabled" olarak atanılan her elementi seçer.
*empty : İçerisinde child bulunmayan her elementi seçer.
*enabled : "disabled" olarak atanılmamış her elementi seçer.
*first-child : Parentının yalnızca ilk chıldı olması durumunda belirtilen elementleri seçer.
*first-letter : Belirtilen elementlerin sadece ilk harfini seçer.
*first-line : Belirtilen elementlerin sadece ilk satırını seçer.
*first-of-type : Parentının belirli bir türündeki ilk chıldı olan her elementi seçer.
*focus : "focus" olabilen her elementi seçer.
*fullscreen : Full-screen modunda olan elementleri seçer.
*hover : Mouseun pointerı ile üzerine gelinen elementleri seçer.
*in-range : Belirtilen bir aralıktaki valueye sahip tüm elementleri seçer.
*indeterminate : İndeterminate(henüz seçilmemiş) durumdaki form elementlerini seçer.
*invalid : Elementin ayarlarına göre doğrulanamayan(invalid) valuelere sahip tüm form elementlerini seçer.
*last-child : Parentının son chıldı olan her elementle elementi seçer.
*last-of-type : Parentının belirli bir türün son chıldı olan her elementle eşleşir.
*link : Henüz ziyaret edilmemiş olan linkleri seçer.
*marker : Bir liste elementinin(display:list-item) işaretçisini(marker) seçer.
*not(selector) : Belirtilen element olmayan diğer tüm elementleri seçer. 
*nth-child(n) : Parentının n'inci chıldı olan her elementi seçer.
*nth-last-child(n) : Parentının n'inci chıldı olan her elementi seçer fakat n sayısı, index olarak sondan başlar.
*nth-last-of-type(n) : Parentının belirli bir türünün n'inci chıldı olan her elementi seçer fakat n sayısı, index olarak sondan başlar.
*nth-of-type(n) : Parentının belirli bir türünün n'inci chıldı olan her elementi seçer.
*only-of-type : Parentının belirli bir türünün tek chıldı olan her elementi seçer.
*only-chıld : Parentının tek chıldı olan her elementi seçer.
*optional : "required" olarak atanmamış form elementleri seçer.
*out-of-range : Belirtilen bir aralığın dışındaki valueye sahip tüm elementleri seçer.
*placeholder : "placeholder" text içeren form elementlerini seçer.
*read-only : "read-only" olarak atanmış olan elementleri seçer.
*read-write : "read-only" ve "disabled" olarak atanmamış olan elementleri seçer.
*required : "required" olarak atanmış form elementleri seçer.
*root : Bu selector, belgenin rootuyla eşleşir.
*selection : Bir elementin kullanıcı tarafından mouse ile seçilen kısmıyla eşleşir.
*target : Belge içerisinde "#" ile başlayan targetlarla bağlantı kurulan URL'lerde target elementlerini seçer.
*valid : Elementin ayarlarına göre doğrulanamayan(invalid) valueye sahip tüm form elementlerini seçer.
*visited : ziyaret edilen linkleri seçer.
*******************
*****FUNCTİONS*****
*calc() : Propertilerin valuelerinde kullanılabilecek hesaplamalar yapar.
*linear-gradient : Arkaplan görseli olarak radial bir gradient ayarlar.
*radial-gradient : Arkaplan görslei olarak radial bir gradient ayarlar.
*repeating-linear-gradient : Linear gradientleri tekrarlamak için kullanılır.
*repeating-radial-gradient : Radial gradientleri tekrarlamak için kullanılır.
*rgba() : Red-Green-Blue-Alpha modelini kullanarak renkleri tanımlar.
*var() : CSS değişkeninin değerini ekler.
*******************
*****RELATİVE LENGTHS*****
*em : Mevcut elementin font sizeına göredir.
*rem : Root elementin(html) font sizeına göredir.
*vw : Viewportun genişliğinin yüzdelik gösterimidir.
*vh : Viewportun yüksekliğinin yüzdelik gösterimidir.
*vmin : Viewportun minimum uzunluğunun yüzdelik gösterimidir.
*vmax : Viewportun maksimum uzunluğunun yüzdelik gösterimidir.
*% : Parentının font sizeına göredir.
***************
*****PROPERTİES*****
*align-content : Çok satırlı container içerisindeki flex lineları(satırları) hizalar.
*align-items : Flex container içerisindeki itemler için default hizalamayı(dikey) belirtir.
*align-self : Flex container içerisindeki seçili item için hizalamayı belirtir.
*all : "unicode-bidi" ve "direction" haricindeki tüm propertileri "initial" veya "inherit" valuelerine resetler.
*animation : Animasyonlar için bir shorthanddir.
*animation-delay : Bir animasyonun başlaması için bir delay(gecikme) belirtir.
*animation-direction : Bir animasyonun ileri mi, geri mi yoksa alternatif looplarda mı yürütüleceğini belirtir.
*animation-duration : Animasyonun bir loopu tamamlamasının ne kadar süreceğini tanımlar.
*animation-fill-mode : Animasyon yürütülmediğinde element için geçerli olacak CSS belirtir.
*animation-iteration-count : Animasyonun kaç defa yürütüleceğini belirtir.
*animation-name : @keyframes animasyonu için bir isim belirtir.
*animation-play-state : Animasyonun çalıştığını veya duraklatıldığını belirtir.
*animation-timing-function : Animasyonun hız eğrisini belirtir.
*backface-visibility : Bir elementin arka yüzünün kullanıcıya bakarken görünüp görünmeyeceğini belirtir.
*background : Arkaplan için bir shorthanddir.
*background-attachment : Arkaplan görselinin sayfanın geri kalanıyla beraber scroll edilip edilmeyeceğini veya sabitleneceğini belirtir.
*background-blend-mode : Her bir arkplan layerının(görsel veya renk) karıştırma modunu tanımlar.
*background-clip : Arkaplan renginin(color) bir element içerisinde ne kadar yayılması gerektiğini tanımlar.
*background-color : Elementin arkaplan rengini ayarlar.
*background-image : Bir element için bir veya birden fazla arkaplan görseli belirtir.
*background-origin : Arkaplan görselinin başlangıç konumunu(arkaplan konumlandırma alanı) belirtir.
*background-position : Arkaplan görselinin konumunu ayarlar.
*background-repeat : Arkaplan görselinin tekrarlanıp tekrarlanmayacağını belirtir.
*background-size : Arkaplan görselinin boyutunu belirtir.
*border : Borderlar için bir shorthanddir.
*border-bottom : Alt border için bir shorthanddir.
*border-bottom-color : Elementin alt borderının rengini belirler.
*border-bottom-left-radius : Sol alt köşenin radiusunu tanımlar.
*border-bottom-right-radius : Sağ alt köşenin radiusunu tanımlar.
*border-bottom-style : Elementin alt borderının türünü tanımlar.
*border-bottom-width : Elementin alt borderının genişliğini belirtir.
*border-collapse : Tablo borderlarının tek bir bordera mı daraltılacağını yoksa HTML standartlarında mı ayrıştırılacağını belirtir.
*border-color : Elementin çevresindeki 4 borderın da rengini belirler.
*border-image : Border görseli için bir shorthanddir.
*border-image-outset : Elementin border görselinin, outset alanına ne kadar yayılacağını belirtir.
*border-image-repeat : Elementin border görselinin tekrarlanması, yuvarlatılması veya yayılması gerektiğini belirtir.
*border-image-slice : Border görselinin nasıl dilimleneceğini belirtir.
*border-image-source : Border görselinin pathıdır.
*border-image-width : Border görselinin genişliğidir.
*border-left : Sol border için bir shorthanddir. 
*border-left-color : Sol borderın rengidir.
*border-left-style : Sol borderın türüdür.
*border-left-width : Sol borderın genişliğidir.
*border-radius : Elementin köşelerinin radiusunu tanımlar.
*border-right : Sağ borderı belirtir.
*border-right-color : Sağ borderın rengidir.
*border-right-style : Sağ borderın türüdür.
*border-right-width : Sağ borderın genişliğidir.
*border-spacing : Bitişik tablo hücrelerinin borderları arasındaki mesafeyi belirtir.
*border-style : Elementin 4 borderının türünü belirtir.
*border-top : Üst border için bir shorthanddir
*border-top-color : Üst borderın rengidir.
*border-top-left-radius : Sol üst köşenin radiusunu belirtir.
*border-top-right-radius : Sağ üst köşenin radiusunu belirtir.
*border-top-style : Elementin üst borderının türünü belirtir.
*border-top-width : Elementin üst borderının genişliğini belirtir.
*border-width : Elementin 4 borderının genişliğini belirtir.
*bottom : Sadece konulandırılmış elementlerin dikey konumunu belirtir.
*box-decoration-break : Elementin boxı parçalandığında bu elementin dekoratif propertilerinin nasıl uygulanacağını seçer.
*box-shadow : Elemente bir veya birden fazla gölge ekleyebilir.
*box-sizing : Elementin genişliğinin ve yüksekliğinin nasıl hesaplanacağını tanımlar.
*break-after : Belirtilen elementten sonra bir sayfa sonu, sütun sonu veya bölge sonu oluşup oluşmayacağını belirtir.
*break-before : Belirtilen elementten önce bir sayfa sonu, sütun sonu veya bölge sonu oluşup oluşmayacağını belirtir.
*break-inside : Belirtilen elementin içerisinde bir sayfa sonu, sütun sonu veya bölge sonu oluşup oluşmayacağını belirtir.
*caption-side : Tablo başlığının yerleşim yerini belirtir.
*caret-color : İnputlarda, textarealarda veya editable herhangi bir elementte imlecin(caret) rengini belirtir.
*@charset : CSS sayfasında kullanılan character encodingi belirtir.
*clear : "float" uygulanmış elementlerin yanlarında kalan elementlerin akışını kontrol eder.
*clip-path : Elementi temel bir şekle veya bir SVG kaynağına kırpmaya imkan sağlar.
*color : Textin rengini belirtir.
*column-count : Bir elementin bölünmesi gereken column sayısını belirtir.
*column-fill : Columnların nasıl dolduralacağını(dengeli olarak veya auto) belirtir.
*column-gap : Columnlar arasındaki boşluğu belirtir.
*column-rule : Column rule için bir shorthanddir.
*column-rule-color : Column ruleun rengini belirtir.
*column-rule-width : Column ruleun genişliğini belirtir.
*column-span : Bir elementin kaç sütuna yayılacağını belirtir.
*column-width : Column genişliğini belirtir.
*columns : Columnlar için bir shorthanddir.
*content : Oluşturulan içeriği eklemek için "before" ve "after" selectorleriyle beraber kullanılır.
*counter-increment : Bir veya daha fazla CSS sayacının değerini artırır veya azaltır.
*counter-reset : Bir veya daha fazla CSS sayacı oluşturur veya resetler.
*cursor : Bir elementin üzerine gelindiğinde görüntülenecek olan mouse imlecidir.
*direction : Blok düzeyinde bir element içerisindeki text yönünü belirtir.
*display : Elementin görüntülenme davranışını(renderleme boxının türünü) belirtir.
*empty-cells : Bir tablodaki boş hücrelerde borderların görüntülenip görüntülenmeyeceğini belirtir.
*filter : Bir görsele efekt(blur, doygunluk,vs) tanımlar.
*flex : Flexible uzunluğu ayarlayan bir shorthanddir.
*flex-basis : Flex itemin initial(başlangıç) uzunluğunu belirtir.
*flex-direction : Flex itemlerin yönünü belirtir.
*flex-flow : Flex itemler için bir shorthanddir.
*flex-grow : Flex itemin, aynı container içerisindeki diğer flex itemlere göre ne kadar büyüyeceğini belirtir.
*flex-shrink : Flex itemin, aynı container içerisindeki diğer flex itemlere göre ne kadar küçüleceğini belirtir.
*flex-wrap : Flex itemlerin, bulunduğu satıra sığmama durumunda alt satıra taşıp taşmayacağını belirtir.
*float : Bir elementi sağa veya sola kaydırabilir.
*font : Text fontu için bir shorthanddir.
*font-family : Elementin fontunu belirtir.
*font-size : Font büyüklüğünü belirtir.
*font-style : Text için font türünü belirtir.
*font-variant : Text içerisinde yazıları büyük harfe dönüştürür fakat font sizelarını küçültür.
*font-weight : Texteki karakterlerin ne kadar kalın veya ince olacağını belirtir.
*gap : Grid gapleri için bir shorthanddir.
*grid : Grid yapıları için shorthanddir.
*grid-area : Grid iteminin boyutunu ve konumunu belirtir ve bir shorthanddir.Ayrıca itemleri adlandırabilir.
*grid-auto-columns : Grid containerındaki columnların boyutlarını ayarlar.
*grid-auto-flow : Otomatik olarak yerleştirilen itemlerin gride nasıl ekleneceğini kontrol eder.
*grid-auto-rows : Grid containerındaki rowların boyutlarını ayarlar.
*grid-column : Grid iteminin boyutunu ve konumunu belirtir.
*grid-column-end : Grid iteminin kaç columna yayılacağını veya itemin hangi column hattında biteceğini tanımlar.
*grid-column-start : Grid iteminin hangi sütun hattında başlayacağını tanımlar.
*grid-gap : Griddeki satırların ve sütunların arasındaki boşlukları tanımlar ve bir shorthanddir.
*grid-row : Grid iteminin boyutunu ve konumunu belirtir ve bir shorthanddir.
*grid-row-end : Grid iteminin kaç rowa yayılacağını veya itemin hangi row hattında biteceğini tanımlar.
*grid-row-start : Grid iteminin hangi row hattında başlayacağını tanımlar.
*grid-template : Grid template için bir shorthanddir.
*grid-template-areas : Grid düzenindeki alanları itemlerin isimleriyle belirtir.
*grid-template-columns : Grid düzenindeki columnların sayısını ve genişliklerini belirtir.
*grid-template-rows : Grid düzenindeki columnların sayısını ve genişliklerini belirtir.
*height : Elementin yüksekliğini belirtir.
*hyphens : Text satırlarında daha yumuşak wrap fırsatları oluşturmak için hyphenationa izin verilip verilmeyeceğini belirtir.
*@import : Bir CSS sayfasını başka bir CSS sayfasına aktarmanıza imkan sağlar.
*justify-content : Flex containerın itemlerini yatay olarak hizalar.
*@keyframes : Animasyon kodunu belirtir.Animasyona yüzdelik dilimlerle(0%-100%) kademeler oluşturur.
*left : Konumlandırılmış(relative,absolute,fixed,sticky) bir elementin yatay konumunu belirtir.
*letter-spacing : Textteki karakterlerin arasındaki boşlukları belirtir.
*line-height : Satırların yüksekliğini belirtir.
*list-style : List style için bir shorthanddir.
*list-style-image : Liste itemi markerını bir görselle değiştirir.
*list-style-position : Liste itemi markerlarının konumunu belirtir.
*list-style-type : Liste itemi markerının türünü belirtir.
*margin : Elementin marginini ayarlar ve bir shorthanddir.
*margin-bottom : Elementin alt marginini ayarlar.
*margin-left : Elementin sol marginini ayarlar.
*margin-right : Elementin sağ marginini ayarlar.
*margin-top : Elementin üst marginini ayarlar.
*max-height : Elementin maksimum yüksekliğini tanımlar.
*max-width : Elementin maksimum genişliğini tanımlar.
*@media : Farklı media türleri ve cihazları için farklı CSSler uygulamak için media querylerinde kullanılır.
*min-height : Elementin mimimum yüksekliğini tanımlar.
*min-width : Elementin minimum genişliğini tanımlar.
*mix-blend-mode : Elementin içeriğinin direkt olarak parentının arkaplanıyla nasıl karışacağını belirtir.
*object-fit : <img> veya <video> elementlerinin, bulundukları containera sığmak için nasıl resize edilmeleri gerektiğini belirtir.
*object-position : <img> veya <video> elementlerinin, bulundukları containerda x/y koordinatlarıyla nasıl konumlandırılacağını belirtir.
*opacity : Elementin opaklık seviyesini belirtir(0-1 arasında).
*order : Aynı container içerisindeki bir flex itemin, diğer flex itemlere göre olan yerleşim sırasını belirtir.
*outline : Elementlerin dış hattında kalan alan için bir shorthanddir.
*outline-color : Elementlerin outlineının rengini belirtir.
*outline-offset : Elementin outlineı ile borderı arasına alan ekler.
*outline-style : Elementin outlineının türünü belirtir.
*outline-width : Elementin outlineının genişliğini belirtir.
*overflow : Elementin içeriğinin, elementin containerına sığmayıp taştığında ne olacağını belirtir.
*overflow-x : Elementin içeriğinin, elementin containerına sığmayıp taştığında ne olacağını belirtir.(x-axis)
*overflow-y : Elementin içeriğinin, elementin containerına sığmayıp taştığında ne olacağını belirtir.(y-axis)
*padding : Elementin içeriği ile borderı arasındaki alandır ve bir shorthanddir.
*padding-bottom : Elementin içeriği ile alt borderı arasındaki alandır ve bir shorthanddir.
*padding-left : Elementin içeriği ile üst borderı arasındaki alandır ve bir shorthanddir.
*padding-right : Elementin içeriği ile sağ borderı arasındaki alandır ve bir shorthanddir.
*padding-top : Elementin içeriği ile üst borderı arasındaki alandır ve bir shorthanddir.
*page-break-after : Belirtilen bir elementten sonra sayfa sonu ekler.
*page-break-before : Belirtilen bir elementten önce sayfa sonu ekler.
*page-break-inside : Belirtilen bir elementin içerisinde sayfa sonu ekler.
*perspective : 3D konumlu bir elemente belirli miktarda perspektif vermek için kullanılır.
*perspective-origin : Kullanıcının 3D konumlu bir elemente hangi konumdan baktığını belirtir.
*pointer-events : Elementin pointer eventlerine tepki verip vermediğini tanımlar.
*position : Element için kullanılan konumlandırma methodunun türünü belirtir(relative,absolute,fixed,sticky).
*quotes : Alıntılar için tırnak işareti(") türünü belirtir.
*resize : Elementin kullanıcılar tarafından resize edilip edilemeyeceğini ve nasıl resize edileceğini belirtir.
*right : Konumlandırılmış(relative,absolute,fixed,sticky) bir elementin yatay konumunu belirtir.
*row-gap : Rowlar arasındaki boşluğu belirtir.
*scroll-behavior : Kullanıcı, scrollable bir box içerisindeki bir linke tıkladığında, targeta doğru düz bir sıçrayış yerine yumuşak bir geçiş sağlar.
*tab-size : Tab karakterlerinin genişliğini belirtir.
*table-layout : Tablo hücrelerini, rowlarını ve columnlarını yerleştirmek için kullanılan algoritmayı tanımlar.
*text-align : Elementin içerisindeki textin yatay hizalanmasını belirtir.
*text-align-last : Bir textin son satırının nasıl hizalanacağını belirtir.
*text-decoration : Texte eklenen dekorasyonu belirtir ve bir shorthanddir.
*text-decoration-color : Textin dekorasyon rengini belirtir.
*text-decoration-line : Textin dekorasyon türünü ayarlar.
*text-decoration-style : Text dekorasyonunun stilini belirtir.
*text-indent : Bir text bloğundaki ilk satırın girintisini belirtir.
*text-justify : Eğer "text-align:justify" ayarlıysa, bu propertiyle de bu ayarlamanın metodunu belirleriz.
*text-overflow : Elemente sığmayığ taşan ve görüntülenemeyen içeriğin, kullanıcıya nasıl bildirileceğini belirtir.
*text-shadow : Texte gölgeler ekler.
*text-transform : Textin büyük-küçük harf kullanımını kontrol eder.
*top : Konumlandırılmış(relative,absolute,fixed,sticky) bir elementin dikey konumunu belirtir.
*transform : Elemente 2D veya 3D dönüşüm uygular.
*transform-origin : Dönüştürülmüş elementlerin x,y ve z eksenlerinde konumunu değiştirmeyi sağlar.
*transform-style : İç içe geçmiş elementlerin 3D alanda nasıl oluşturulacağını belirtir.
*transition : Transition için bir shorthanddir.
*transition-delay : "transition" efektlerinin ne zaman başlayacağını belirtir.
*transition-duration : "transition" efektlerinin ne kadar sürede tamamlanacağını belirtir.
*transition-property : "transition" efektlerinin ait olduğu CSS propertisinin adını belirtir.
*transition-timing-function : "transition" efektlerinin hız eğrilerini belirtir.
*unicode-bidi : Aynı belgede birden çok dili desteklemek için metnin geçersiz kılınıp kılınmayacağını ayarlamak için kullanılır.
*user-select : Elementin textinin seçilip seçilemeyeceğini belirtir.
*vertical-align : Elementin dikey hizalamasını sağlar(genellikle <img> ve <video>).
*visibility : Elementin görünür olup olmadığını belirtir.
*white-space : Elementin içerisinde boşlukların nasıl işlendiğini belirtir.
*width : Elementin genişliğini belirtir.
*word-break : Satır sonuna ulaşıldığında kelimelerin nasıl kesileceğini belirtir.
*word-spacing : Kelimeler arasındaki boşlukları azaltır veya artırır.
*word-wrap : Uzun kelimelerin bölünebilmesini ve bir sonraki satıra wraplenmesini sağlar.
*writing-mode : Text satırlarının yatay mı yoksa dikey mi yerleştirileceğini belirtir.
*z-index : Elementin görüntülenirken ki öncelik sırasını belirtir.
********************